WWWWWWWWWWWWWWW
WW_W___SWWWW_WW
W____WWWW__W__W
W_WW_W_E_W_W_WW
W_WW_W_W_W____W
W_WW___W_WWW_WW
W____W________W
WWWWWWWWWWWWWWW