WWWWWWWWWWWWWWW
WW_W____WWWW_WW
W____WWWW__W__W
W_WW_W_WWW_WSWW
W_WW_W___W____W
W_WW___W_W_W_WW
W____WW_______W
WW_W___WWWWW_WW
W____WWWW__W__W
W_WW_W_WWW_W_WW
W_WW_____W____W
W_WWWW_W_W_W_WW
W_WW_W_WWW____W
WWWW___W_W_W_WW
W____W________W
WW_W____WWWW_WW
W____WWWW__W__W
W_WW_W_WWW_W_WW
W_WW_W_W_W____W
WWWWWW_W_W_W_WW
W_E___________W
WWWWWWWWWWWWWWW