WWWWWWWWWWWWWWW
WW_W____WWWW_WW
W____WWWW__W__W
W_WW_W_WWW_WSWW
W_WW_W_W_W____W
W_WW___W_W_W_WW
W_E__W________W
WWWWWWWWWWWWWWW